+-+-+-+-+-+-+-+-+-+-+
 X    |   |   |     |
+-+-+ + + +-+ + +-+ +
| |     | |   |   | |
+ + + +-+ + +-+-+ +-+
| | | |   | |   |   |
+ + + + +-+ + + +-+ +
|   | |       |     |
+-+-+ +-+-+-+-+-+-+-+
|     |     |   |   |
+ +-+-+ +-+ + + +-+ +
|     |   | | | |   |
+-+-+ +-+ + + + + + +
|     |   |   |   | |
+ +-+-+ +-+-+-+-+-+ +
|       |       |   |
+-+-+-+-+ +-+-+ + +-+
| |           | |   |
+ + + + +-+-+ +-+-+ +
|   | |     |      O 
+-+-+-+-+-+-+-+-+-+-+
