+-+-+-+-+-+-+-+-+-+-+
 X    |             |
+-+-+ + +-+ +-+-+-+ +
|     | |   |       |
+ +-+-+ +-+-+-+-+-+-+
|     |   |     |   |
+-+-+ +-+ +-+-+ + + +
| |   |       |   | |
+ + +-+ +-+-+ +-+-+ +
|   |       |   |   |
+ + + +-+-+ +-+ + + +
| | | |     |     | |
+-+ +-+ + +-+-+-+-+ +
|   |   | |         |
+ +-+ +-+ +-+-+-+-+-+
| |   | | |       | |
+ + + + + + +-+-+ + +
|   |   |   |   | | |
+-+-+-+-+-+ + +-+ + +
|           |      O 
+-+-+-+-+-+-+-+-+-+-+
