+-+-+-+-+-+-+-+-+-+-+
 X        |   |     |
+ +-+-+-+ +-+ + + + +
| |     |   | | | | |
+ + +-+ +-+ + + + + +
| | | | | | |   | | |
+ + + + + + +-+-+-+ +
| |   |     |       |
+ +-+-+ +-+-+ +-+-+-+
| |   | |         | |
+ +-+ + + + +-+-+ + +
| |   |   | |   | | |
+ + + +-+-+ + +-+ + +
|   | |   | | |   | |
+-+-+ + +-+ + + +-+ +
|   | |   | | | |   |
+ + + +-+ + + + + +-+
| | |   | | |   |   |
+ + +-+ + + + +-+ + +
| |     |   |     |O 
+-+-+-+-+-+-+-+-+-+-+
