+-+-+-+-+-+-+-+-+-+-+
 X|         |   |   |
+ +-+-+ +-+ +-+ + + +
|     | |   |   | | |
+ +-+ +-+ +-+ +-+ +-+
|   | |         |   |
+-+ + + +-+-+-+ +-+ +
|   |   |     | |   |
+ +-+-+-+-+ + +-+ +-+
|   |   |   |   | | |
+-+ + + + +-+-+ + + +
|   | |       |   | |
+ +-+ +-+-+-+ +-+-+ +
|     |       |     |
+-+ +-+ +-+-+-+ +-+-+
| | | | |     |   | |
+ + + + + +-+ +-+ + +
|     |     |       |
+-+-+-+-+-+ +-+-+ + +
|           |     |O 
+-+-+-+-+-+-+-+-+-+-+
