+-+-+-+-+-+-+-+-+-+-+
 X    |       |   | |
+ +-+ + +-+-+ + + + +
|   | | |   | | |   |
+-+ + + + +-+ + +-+-+
|   |   |   |   |   |
+ +-+-+-+-+ + +-+ + +
| |   |   |   |   | |
+ + + + +-+ +-+-+-+ +
|   | |     |   |   |
+-+-+ +-+-+-+ + + +-+
|     |   |   | |   |
+ +-+-+ + +-+-+ + + +
| |     |     | | | |
+ + +-+-+-+-+ + + + +
| |   |         | | |
+ +-+ + +-+-+-+-+ + +
|     |   |       | |
+-+-+-+-+ +-+ +-+-+ +
|             |    O 
+-+-+-+-+-+-+-+-+-+-+
