+-+-+-+-+-+-+-+-+-+-+
 X  |       |       |
+-+ + + +-+ + +-+-+-+
| |   | |   |       |
+ +-+-+-+ +-+-+-+-+ +
|   | |   |         |
+ + + + +-+ +-+-+-+-+
| |         |       |
+ +-+ +-+-+-+-+-+-+ +
| | | |           | |
+ + + +-+ +-+-+-+ + +
| | |     | |     | |
+ + + +-+-+ + +-+-+ +
|   | | |     |     |
+-+ + + + +-+-+-+ +-+
|   |   |           |
+ +-+-+-+-+-+-+-+-+-+
| |   |   |     |   |
+ + + + + +-+ + + + +
|   |   |     |   |O 
+-+-+-+-+-+-+-+-+-+-+
