+-+-+-+-+-+-+-+-+-+-+
 X|     |       |   |
+ + +-+ + +-+-+ +-+ +
| | |   | |   |     |
+ + + +-+ + + +-+-+ +
|   |   | | | |   | |
+-+-+-+ + +-+ + +-+ +
|   | |   |   |   | |
+ + + +-+-+ +-+-+ + +
| | |   |         | |
+ + +-+ + +-+-+-+ + +
| |   | |       |   |
+ +-+ + +-+ +-+ +-+-+
|   | |   |   |     |
+ +-+ + +-+-+-+-+-+ +
| |   | |           |
+ + +-+ + +-+-+ +-+-+
| |   | |     | |   |
+ +-+ + + +-+ + + + +
|   |     |   |   |O 
+-+-+-+-+-+-+-+-+-+-+
