+-+-+-+-+-+-+-+-+-+-+
 X|       |     |   |
+ + +-+-+ +-+-+ +-+ +
|   |   | |       | |
+-+-+ + + + +-+-+ + +
|     |   |     |   |
+ +-+-+-+-+-+ + +-+ +
|   |   |     |   | |
+ + + + + +-+-+-+ +-+
| |   |   |         |
+ +-+-+-+-+-+-+-+-+ +
|   |   |   |       |
+-+ +-+ + + + +-+-+-+
|   |   | | |       |
+ +-+ +-+ +-+-+-+-+ +
| |   |             |
+ + +-+-+ + +-+-+-+-+
| | |   | |   |     |
+ + + + + +-+-+ +-+ +
|   | |         |  O 
+-+-+-+-+-+-+-+-+-+-+
