+-+-+-+-+-+-+-+-+-+-+
 X  |       |   |   |
+ + + +-+-+ +-+ + + +
| | |   |   |   | | |
+ + + + + +-+ +-+ + +
| |   | |     |   | |
+-+-+-+ +-+-+-+ +-+ +
|   |   |   |   | | |
+ + + +-+ + + +-+ + +
| | |     | | |   | |
+ + +-+-+-+ + + + + +
| |     |   | | |   |
+ +-+ + + +-+ + +-+-+
|   | |   |   | |   |
+-+ + +-+-+ +-+ + +-+
| | |   |   |   |   |
+ + + +-+ +-+ +-+-+ +
| | |     |         |
+ + +-+-+-+ + +-+-+-+
|   |       |      O 
+-+-+-+-+-+-+-+-+-+-+
