+-+-+-+-+-+-+-+-+-+-+
 X      |           |
+ +-+-+ + +-+-+-+-+ +
| |   |   |         |
+ + +-+-+-+ +-+-+-+-+
| | |   |   |   |   |
+ + + + + +-+-+ + +-+
|   | |   |   |     |
+-+-+ +-+-+ + +-+-+ +
|     |     | | |   |
+ +-+-+ +-+-+ + + +-+
|       |     | | | |
+-+-+ +-+ +-+-+ + + +
|   | |   |     | | |
+ + +-+ +-+ +-+ + + +
| | |     | | |   | |
+ + + +-+ + + +-+ + +
| |   |   |     |   |
+ +-+-+ +-+-+ +-+-+-+
|     |            O 
+-+-+-+-+-+-+-+-+-+-+
